# Gboard Dictionary version:1
abl	efficient*	en-US
able	competent to*	en-US
abs	of course*	en-US
absol	precisely*	en-US
abu	numerous*	en-US
accur	exact*	en-US
ado	captivating*	en-US
ador	delightful*	en-US
adora	charming*	en-US
adorab	endearing*	en-US
afrai	terrified*	en-US
afraid	fearful*	en-US
aged	elderly*	en-US
agg	overconfident*	en-US
aggr	forceful*	en-US
aggre	insistent*	en-US
aggres	hardline*	en-US
ama	shocked*	en-US
amaz	astounded*	en-US
amaze	flabbergasted*	en-US
amazed	astonished*	en-US
amb	competitive*	en-US
ambi	driven*	en-US
ambit	cutthroat*	en-US
ambiti	bloodthirsty*	en-US
anc	primal*	en-US
anci	grizzled*	en-US
ancie	hoary*	en-US
ancien	grey*	en-US
ancient	decrepit*	en-US
ang	enraged*	en-US
angr	irate*	en-US
angry	furious*	en-US
anx	restless*	en-US
anxi	dismayed*	en-US
anxio	apprehensive*	en-US
anxiou	fretful*	en-US
app	evidently*	en-US
appa	evident*	en-US
appro	significant*	en-US
ari	sere*	en-US
arid	parched*	en-US
ash	pale*	en-US
asha	embarrassed*	en-US
asham	humiliated*	en-US
ashame	discomfited*	en-US
ashamed	mortified*	en-US
ashe	white*	en-US
ashen	pallid*	en-US
att	fond of*	en-US
atta	devoted*	en-US
attac	attentive*	en-US
attach	enamored*	en-US
attache	doting*	en-US
atte	sympathetic*	en-US
attentive	compassionate*	en-US
aut	genuine*	en-US
awa	mindful*	en-US
awar	alert*	en-US
aware	savvy*	en-US
away	distant*	en-US
awf	nasty*	en-US
awfu	awful*	en-US
awful	appalling*	en-US
bad	atrocious*	en-US
bas	primary*	en-US
bea	gorgeous*	en-US
beau	exquisite*	en-US
beaut	exquisite*	en-US
beauti	magnificent*	en-US
beautiful	stunning*	en-US
bed	infirm*	en-US
bedr	ailing*	en-US
bedri	terminal*	en-US
bedrid	incurable*	en-US
bel	precious*	en-US
big	immense*	en-US
bla	ebony*	en-US
blac	sooty*	en-US
black	lightless*	en-US
ble	fortunate*	en-US
bles	fluky*	en-US
bli	euphoric*	en-US
blis	elated*	en-US
blu	round*	en-US
bon	skeletal*	en-US
bony	angular*	en-US
bor	dull*	en-US
bore	dull*	en-US
bori	tedious*	en-US
borin	dreary*	en-US
boring	uninteresting*	en-US
bri	intellectual*	en-US
brie	diminutive*	en-US
brief	petite*	en-US
brig	astute*	en-US
brigh	dazzling*	en-US
bright	luminous*	en-US
broke	penniless*	en-US
bru	murderous*	en-US
bur	scorching*	en-US
burn	scalding*	en-US
burni	blistering*	en-US
burnin	searing*	en-US
calm	serene*	en-US
cap	skillful*	en-US
capa	efficient*	en-US
capab	competent*	en-US
capabl	adept*	en-US
capable	proficient*	en-US
car	cautious*	en-US
care	meticulous*	en-US
caref	fastidious*	en-US
carefu	precise*	en-US
careful	scrupulous*	en-US
cau	careful*	en-US
cel	famous*	en-US
cheap	stingy*	en-US
chi	immature*	en-US
cle	spotless*	en-US
clea	pristine*	en-US
clean	immaculate*	en-US
clear	definite*	en-US
clev	brillant*	en-US
cleve	astute*	en-US
clever	intelligent*	en-US
clu	confused*	en-US
col	icy*	en-US
cold	freezing*	en-US
colo	vivid*	en-US
color	vibrant*	en-US
colorf	variegated*	en-US
colorful	vibrant*	en-US
com	predictable*	en-US
comm	conventional*	en-US
commo	typical*	en-US
common	traditional*	en-US
comp	cutthroat*	en-US
con	persuasive*	en-US
conf	perplexed*	en-US
confu	befuddled*	en-US
confus	mystified*	en-US
confuse	baffled*	en-US
confused	dazed*	en-US
cons	uniform*	en-US
consi	harmonious*	en-US
cont	argumentative*	en-US
conto	mutilated*	en-US
contor	deformed*	en-US
contr	confrontational*	en-US
conv	believable*	en-US
convi	compelling*	en-US
cool	confident*	en-US
cor	dishonest*	en-US
corr	fraudulent*	en-US
corru	crooked*	en-US
corrup	unethical*	en-US
corrupt	rotten*	en-US
cos	expensive*	en-US
cost	overpriced*	en-US
costl	exorbitant*	en-US
costly	extravagant*	en-US
cra	crusty*	en-US
crac	gritty*	en-US
cre	weird*	en-US
crea	innovative*	en-US
cree	sinister*	en-US
cri	crackling*	en-US
cris	crunchy*	en-US
crisp	brittle*	en-US
crispy	gravelly*	en-US
crit	fatalistic*	en-US
criti	pessimistic*	en-US
critic	defeatist*	en-US
critica	cynical*	en-US
critical	essential*	en-US
crow	bustling*	en-US
cru	important*	en-US
cur	inquisitive*	en-US
curi	nosy*	en-US
curio	prying*	en-US
curiou	snoopy*	en-US
curious	quizzical*	en-US
cut	adorable*	en-US
cute	pretty*	en-US
dan	dicey*	en-US
dang	threatening*	en-US
dar	black*	en-US
dark	inky*	en-US
dea	booming*	en-US
deaf	blaring*	en-US
dear	cherished*	en-US
dec	noble*	en-US
dece	respectable*	en-US
dee	profound*	en-US
deep	yawning*	en-US
del	conscious*	en-US
deli	flimsy*	en-US
delib	intentional*	en-US
delibe	premeditated*	en-US
deliber	willful*	en-US
delic	slight*	en-US
delica	precarious*	en-US
delicat	frail*	en-US
delicate	subtle*	en-US
dep	immoral*	en-US
depr	dismal*	en-US
depre	cheerless*	en-US
depres	morbid*	en-US
des	dire*	en-US
dest	impoverished*	en-US
desti	destitute/underprivileged*	en-US
det	resolute*	en-US
detail	meticulous*	en-US
dete	adamant*	en-US
deter	obstinate*	en-US
determ	tenacious*	en-US
determi	dogged*	en-US
dif	complex*	en-US
diff	challenging*	en-US
diffe	distinctive*	en-US
differ	atypical*	en-US
differe	dissimilar*	en-US
differen	disparate*	en-US
diffi	complicated*	en-US
diffic	demanding*	en-US
difficu	arduous*	en-US
dir	filthy*	en-US
dirt	polluted*	en-US
dirty	foul*	en-US
dis	sassy*	en-US
disg	bad*	en-US
disr	cheeky*	en-US
disre	impertinent*	en-US
disres	insolent*	en-US
dist	far off*	en-US
dog	opinionated*	en-US
drain	weary*	en-US
dre	terrible*	en-US
dru	smashed*	en-US
drun	inebriated*	en-US
drunk	intoxicated*	en-US
dry	parched*	en-US
dub	suspicious*	en-US
dul	mind-numbing*	en-US
dull	tedious*	en-US
eag	keen*	en-US
eage	impatient*	en-US
eager	keen*	en-US
eas	simple*	en-US
easy	effortless*	en-US
edu	informative*	en-US
eff	proficient*	en-US
effi	resourceful*	en-US
emb	ashamed*	en-US
emo	sensitive*	en-US
empty	desolate*	en-US
ene	lively*	en-US
ener	vivacious*	en-US
energ	exuberant*	en-US
energe	spirited*	en-US
energet	animated*	en-US
enj	agreeable*	en-US
enjo	satisfying*	en-US
enjoy	kind*	en-US
eno	plenty*	en-US
enou	much*	en-US
enoug	oceans*	en-US
enough	heaps*	en-US
ent	zealous*	en-US
enth	optimistic*	en-US
enthu	encouraged*	en-US
enthus	vehement*	en-US
enthusi	ebullient*	en-US
env	jealous*	en-US
ess	indispensable*	en-US
esse	integral*	en-US
evil	wicked*	en-US
exac	indistinguishable*	en-US
exc	superior*	en-US
exce	superb*	en-US
exci	exhilarating*	en-US
excit	thrilling*	en-US
exciti	breathtaking*	en-US
exciting	exhilarating*	en-US
exp	roomy*	en-US
expa	spacious*	en-US
expan	vast*	en-US
expans	palatial*	en-US
expansi	commodious*	en-US
ext	impressive*	en-US
exte	protracted*	en-US
exten	widespread*	en-US
fade	evaporate*	en-US
fai	impartial*	en-US
fair	equitable*	en-US
fait	devoted*	en-US
faith	staunch*	en-US
faithf	loyal*	en-US
faithfu	stalwart*	en-US
fam	celebrated*	en-US
famo	renowned*	en-US
famou	eminent*	en-US
famous	legendary*	en-US
far	outlying*	en-US
fas	quick*	en-US
fast	rapid*	en-US
fat	obese*	en-US
few	limited*	en-US
fil	grimy*	en-US
filt	squalid*	en-US
filth	dilapidated*	en-US
fir	unyielding*	en-US
firm	difficult*	en-US
fit	vigorous*	en-US
fiz	frothy*	en-US
fle	cottony*	en-US
flo	graceful*	en-US
flu	fleecy*	en-US
fluf	downy*	en-US
fluff	fuzzy*	en-US
fluffy	feathery*	en-US
fond	devoted to*	en-US
fra	delicate*	en-US
fre	frigid*	en-US
free	bitter*	en-US
freez	glacial*	en-US
freezi	frosty*	en-US
freezin	polar*	en-US
fri	outgoing*	en-US
frie	gregarious*	en-US
frien	chummy*	en-US
friend	demonstrative*	en-US
friendl	amiable*	en-US
friendly	affectionate*	en-US
fro	fizzy*	en-US
frot	effervescent*	en-US
froth	foamy*	en-US
frothy	sudsy*	en-US
fru	exasperating*	en-US
frus	infuriating*	en-US
frust	disheartening*	en-US
frustr	vexing*	en-US
ful	packed*	en-US
full	sated*	en-US
fun	hilarious*	en-US
funn	hysterical*	en-US
funny	sidesplitting*	en-US
fur	incensed*	en-US
furi	fuming*	en-US
furio	livid*	en-US
furiou	flurious*	en-US
gen	authentic*	en-US
gener	benevolent*	en-US
genu	realistic*	en-US
genui	credible*	en-US
genuin	rational*	en-US
gif	bright*	en-US
gift	intelligent*	en-US
gifte	brainy*	en-US
gifted	clever*	en-US
gla	transparent*	en-US
glad	overjoyed*	en-US
glas	clear*	en-US
glass	sheer*	en-US
glassy	translucent*	en-US
glu	impatient*	en-US
goo	excellent*	en-US
good	outstanding*	en-US
gor	beautiful*	en-US
gory	barbarous*	en-US
gra	flowing*	en-US
grac	supple*	en-US
grace	lithe*	en-US
gracef	willowy*	en-US
gracefu	lissome*	en-US
gre	gluttonous*	en-US
gree	avaricious*	en-US
greed	materialistic*	en-US
greedy	insatiable*	en-US
hai	unshaven*	en-US
hair	hirsute*	en-US
hairy	shaggy*	en-US
han	useful*	en-US
hand	close-by*	en-US
handy	nearby*	en-US
hap	blissful*	en-US
happ	ecstatic*	en-US
happy	overjoyed*	en-US
har	solid*	en-US
hard	firm*	en-US
haz	precarious*	en-US
hea	weighty*	en-US
heal	hardy*	en-US
healt	hale*	en-US
health	flourishing*	en-US
healthy	robust*	en-US
heav	dense*	en-US
heavy	leaden*	en-US
hel	supportive*	en-US
help	obliging*	en-US
helpf	accommodating*	en-US
helpfu	invaluable*	en-US
hid	repugnant*	en-US
hide	grotesque*	en-US
hideo	higeous*	en-US
hideou	Ã¿hideous*	en-US
hil	rollicking*	en-US
hon	sincere*	en-US
hone	candid*	en-US
hones	authentic*	en-US
honest	forthright*	en-US
hos	belligerent*	en-US
hot	burning*	en-US
hug	gargantuan*	en-US
hun	starving*	en-US
hung	hollow*	en-US
hungr	famished*	en-US
hungry	ravenous*	en-US
ill	bedridden*	en-US
imm	depraved*	en-US
imma	infantile*	en-US
immat	naive*	en-US
immatu	jejune*	en-US
immatur	callow*	en-US
immature	green*	en-US
immo	decadent*	en-US
immor	debauched*	en-US
immora	iniquitous*	en-US
imp	crucial*	en-US
impa	nonpartisan*	en-US
impar	neutral*	en-US
impo	vital*	en-US
impor	essential*	en-US
import	paramount*	en-US
importa	imperative*	en-US
important	noteworthy*	en-US
impr	remarkable*	en-US
impre	awe-inspiring*	en-US
impress	extraordinary*	en-US
inf	educational*	en-US
info	enlightening*	en-US
infor	edifying*	en-US
inform	revealing*	en-US
ink	starless*	en-US
inky	unlit*	en-US
int	fascinating*	en-US
inte	crafty*	en-US
intel	sharp*	en-US
intense	acute*	en-US
inter	riveting*	en-US
intere	compelling*	en-US
interer	attentive*	en-US
iso	remote*	en-US
isol	secluded*	en-US
isola	extrasolar*	en-US
jea	envious*	en-US
jeal	resentful*	en-US
jealo	grudging*	en-US
jealou	green*	en-US
jealous	bitter*	en-US
jui	ripe*	en-US
juic	fleshy*	en-US
juicy	succulent*	en-US
kee	enthusiastic*	en-US
keen	ardent*	en-US
arde	ferocious*	en-US
kin	attentive*	en-US
kind	caring*	en-US
lar	huge*	en-US
larg	humongous*	en-US
large	mammoth*	en-US
lazy	indolent*	en-US
lig	luminous*	en-US
ligh	buoyant*	en-US
light	insubstantial*	en-US
lik	expected*	en-US
like	imminent*	en-US
likel	probable*	en-US
likely	unavoidable*	en-US
lim	few*	en-US
limi	meager*	en-US
limit	scarce*	en-US
limite	scant*	en-US
limited	negligible*	en-US
little	tiny*	en-US
liv	energetic*	en-US
lively	animated*	en-US
log	rational*	en-US
logi	cogent*	en-US
logic	credible*	en-US
logica	consistent*	en-US
logical	sound*	en-US
lon	extended*	en-US
lone	deserted*	en-US
lonel	forlorn*	en-US
lonely	solitary*	en-US
long	extensive*	en-US
long-term	enduring*	en-US
lou	deafening*	en-US
loud	thunderous*	en-US
loved	adored*	en-US
loy	faithful*	en-US
luc	blessed*	en-US
luck	charmed*	en-US
lucky	favored*	en-US
lum	weightless*	en-US
lumi	airy*	en-US
lumin	ethereal*	en-US
lux	excessive*	en-US
luxu	opulent*	en-US
luxur	sumptuous*	en-US
maj	vital*	en-US
majo	significant*	en-US
major	key*	en-US
mel	musical*	en-US
min	aware*	en-US
mind	apprised*	en-US
mis	depressing*	en-US
moo	morose*	en-US
mood	temperamental*	en-US
moody	unstable*	en-US
mor	moody*	en-US
mot	zealous*	en-US
mus	melodic*	en-US
musi	melodious*	en-US
music	harmonious*	en-US
musica	dulcet*	en-US
nea	hygienic*	en-US
near	convenient*	en-US
neat	immaculate*	en-US
neatl	orderly*	en-US
nece	essential*	en-US
neg	critical*	en-US
nervous	apprehensive*	en-US
new	novel*	en-US
nic	kind*	en-US
nice	pleasant*	en-US
nob	decent*	en-US
nobl	civilized*	en-US
noble	upright*	en-US
noisy	deafening*	en-US
nov	fresh*	en-US
nove	innovative*	en-US
novel	original*	en-US
num	abundant*	en-US
nume	copious*	en-US
numer	myriad*	en-US
numero	profuse*	en-US
numerou	diverse*	en-US
obe	blubbery*	en-US
obes	corpulent*	en-US
obese	rotund*	en-US
obv	apparent*	en-US
obvi	evident*	en-US
obvio	apparent*	en-US
off	contrary*	en-US
offe	obnoxious*	en-US
offen	insolent*	en-US
offens	derogatory*	en-US
offensi	boorish*	en-US
offensive	repugnant*	en-US
often	frequently*	en-US
oka	absolutely*	en-US
okay	much so*	en-US
old	ancient*	en-US
opi	dogmatic*	en-US
opin	cocksure*	en-US
opini	biased*	en-US
opinio	partisan*	en-US
opt	enthusiastic*	en-US
out	friendly*	en-US
ove	aggressive*	en-US
pac	overflowing*	en-US
pack	bursting*	en-US
packe	crammed*	en-US
pai	unbearable*	en-US
pain	agonizing*	en-US
painf	excruciating*	en-US
painfu	searing*	en-US
painful	excruciating*	en-US
pal	ashen*	en-US
pale	sallow*	en-US
par	arid*	en-US
per	convincing*	en-US
ple	scads*	en-US
plea	fulfilling*	en-US
pleas	rewarding*	en-US
pleasa	gratifying*	en-US
pleasan	amiable*	en-US
plen	oodles*	en-US
plent	loads*	en-US
pol	respectful*	en-US
poo	destitute*	en-US
poor	indigent*	en-US
pop	trendy*	en-US
popu	fashionable*	en-US
popul	admired*	en-US
popula	prevalent*	en-US
pos	luxurious*	en-US
posh	lavish*	en-US
posi	affirmative*	en-US
posit	optimistic*	en-US
positi	upbeat*	en-US
powerful	compelling*	en-US
pra	realistic*	en-US
prac	sensible*	en-US
pract	judicious*	en-US
practi	doable*	en-US
practic	viable*	en-US
pre	tidy*	en-US
prec	loved*	en-US
preci	adored*	en-US
precio	cherished*	en-US
preciou	revered*	en-US
pres	shipshape*	en-US
prese	well-groomed*	en-US
presen	personable*	en-US
pri	basic*	en-US
prim	rudimentary*	en-US
prima	fundamental*	en-US
primar	simple*	en-US
pro	productive*	en-US
prod	fertile*	en-US
produ	fruitful*	en-US
produc	rich*	en-US
product	lush*	en-US
producti	fecund*	en-US
prof	bottomless*	en-US
profo	abysmal*	en-US
profou	vast*	en-US
pur	clean*	en-US
pure	wholesome*	en-US
qui	swift*	en-US
quic	fleet*	en-US
quick	blistering*	en-US
quiet	silent*	en-US
rad	intense*	en-US
radi	luminous*	en-US
rainy	pouring*	en-US
rap	supersonic*	en-US
rapi	ripid*	en-US
rar	unique*	en-US
rare	occasionally*	en-US
rarel	infrequently*	en-US
rarely	seldom*	en-US
rat	logical*	en-US
rays	radiant*	en-US
rea	practical*	en-US
rec	current*	en-US
rece	the latest*	en-US
recen	fresh*	en-US
recent	up-to-date*	en-US
rel	feral*	en-US
reli	devout*	en-US
relig	pious*	en-US
religi	fervent*	en-US
religio	dedicated*	en-US
res	anxious*	en-US
resp	conscientious*	en-US
respe	courteous*	en-US
respec	cultured*	en-US
respect	mannerly*	en-US
respo	reliable*	en-US
respon	steadfast*	en-US
ric	smooth*	en-US
rich	wealthy*	en-US
rip	moist*	en-US
ripe	luscious*	en-US
ris	hazardous*	en-US
risk	perilous*	en-US
risky	treacherous*	en-US
roo	expansive*	en-US
roomy	spacious*	en-US
rot	miserable*	en-US
rott	atrocious*	en-US
rou	rugged*	en-US
roug	coarse*	en-US
rough	jagged*	en-US
row	disorderly*	en-US
rowd	raucous*	en-US
rowdy	unruly*	en-US
rud	offensive*	en-US
rude	disagreeable*	en-US
rug	craggy*	en-US
rugg	gritty*	en-US
rugge	rough*	en-US
sad	sorrowful*	en-US
saf	secure*	en-US
safe	protected*	en-US
sal	pasty*	en-US
sall	ashed*	en-US
sam	constant*	en-US
same	identical*	en-US
sas	disrespectful*	en-US
sat	pleasant*	en-US
satu	waterlogged*	en-US
satur	sopping*	en-US
sav	brutal*	en-US
sava	relentless*	en-US
savag	gory*	en-US
savage	vicious*	en-US
sca	terrified*	en-US
scar	petrified*	en-US
scare	terror-stricken*	en-US
scared	panicked*	en-US
sec	poised*	en-US
secu	self-assured*	en-US
secur	sheltered*	en-US
secure	self-reliant*	en-US
see	apparently*	en-US
sel	rarely*	en-US
sen	emotional*	en-US
sens	demonstrative*	en-US
sensi	temperamental*	en-US
ser	desperate*	en-US
sere	withered*	en-US
seri	frantic*	en-US
serio	fraught*	en-US
seriou	grave*	en-US
serious	hopeless*	en-US
sev	intense*	en-US
seve	extreme*	en-US
sever	fierce*	en-US
severe	overpowering*	en-US
sha	vibrating*	en-US
sharp	keen*	en-US
shiny	gleaming*	en-US
sho	amazed*	en-US
shor	stubby*	en-US
short	brief*	en-US
shy	timid*	en-US
sig	appropriate*	en-US
sign	relevant*	en-US
signi	germane*	en-US
signif	pertinent*	en-US
sil	quiet*	en-US
sile	hushed*	en-US
silen	noiseless*	en-US
silent	still*	en-US
sim	uncomplicated*	en-US
simp	unchallenging*	en-US
simpl	unceremonious*	en-US
simple	easygoing*	en-US
sin	frank*	en-US
ske	bony*	en-US
skel	gaunt*	en-US
skele	emaciated*	en-US
ski	capable*	en-US
skinny	skeletal*	en-US
sleepy	lethargic*	en-US
slow	sluggish*	en-US
sma	soused*	en-US
smart	intelligent*	en-US
smas	plastered*	en-US
smelly	pungent*	en-US
smo	sleek*	en-US
smoo	greasy*	en-US
smoot	buttery*	en-US
smooth	creamy*	en-US
sol	rigid*	en-US
soli	set*	en-US
solid	frozen*	en-US
sor	wretched*	en-US
sorr	desolate*	en-US
sorro	disconsolate*	en-US
sorrow	dejected*	en-US
spi	religious*	en-US
spo	tidy*	en-US
spot	uncluttered*	en-US
spotl	immaculate*	en-US
sta	voracious*	en-US
strong	unyielding*	en-US
stupid	idiotic*	en-US
sus	dubious*	en-US
susp	skeptical*	en-US
suspi	cynical*	en-US
suspic	unconvinced*	en-US
tall	towering*	en-US
tasty	delicious*	en-US
ter	dreadful*	en-US
terr	horrendous*	en-US
terri	horrific*	en-US
terrib	shocking*	en-US
the	melodramatic*	en-US
thin	gaunt*	en-US
thr	exciting*	en-US
tid	presentable*	en-US
tim	backward*	en-US
timi	introverted*	en-US
timid	withdrawn*	en-US
tired	exhausted*	en-US
tou	difficult*	en-US
toug	hard*	en-US
tough	inflexible*	en-US
tra	crystal*	en-US
tran	obvious*	en-US
tre	popular*	en-US
ugl	hideous*	en-US
ugly	revolting*	en-US
unb	painful*	en-US
unf	unjust*	en-US
unfa	bigoted*	en-US
unfai	prejudiced*	en-US
unfair	inequitable*	en-US
uni	sparse*	en-US
uniq	exceptional*	en-US
uniqu	peerless*	en-US
unj	unfair*	en-US
uns	dangerous*	en-US
unsa	perilous*	en-US
unsaf	precarious*	en-US
unsafe	treacherous*	en-US
unsh	bushy*	en-US
unu	unusual*	en-US
upb	positive*	en-US
ups	worried*	en-US
upse	concerned*	en-US
upset	distraught*	en-US
valu	precious*	en-US
vib	shaky*	en-US
vibr	tremulous*	en-US
vibra	quaking*	en-US
vibrat	unsteady*	en-US
vis	prominent*	en-US
visi	conspicuous*	en-US
visib	exposed*	en-US
visibl	obvious*	en-US
vit	major*	en-US
vita	critical*	en-US
vital	crucial*	en-US
viv	theatrical*	en-US
vivi	dramatic*	en-US
vivid	histrionic*	en-US
vul	offensive*	en-US
weak	frail*	en-US
wei	ponderous*	en-US
weig	hefty*	en-US
weir	spooky*	en-US
weird	unnerving*	en-US
wet	saturated*	en-US
wick	villainous*	en-US
wid	extensive*	en-US
wide	pervasive*	en-US
wides	prevalent*	en-US
widesp	rampant*	en-US
wil	rowdy*	en-US
wild	boisterous*	en-US
will	eager*	en-US
wis	sagacious*	en-US
wise	sage*	en-US
wor	distressed*	en-US
worr	agitated*	en-US
worried	distressed*	en-US
yes	absolutely*	en-US
zea	enthusiastic*	en-US
zeal	driven*	en-US
zealo	ambitious*	en-US
zealou	passionate*	en-US
marv	alluring*	en-US
bye	adios*	en-US
tata	cheerio*	en-US
imo	in my opinion*	en-US
afa	as far as I'm concerned*	en-US
ass	I assume*	en-US
view	from my point of view*	en-US
howe	although*	en-US
howev	on the another hand*	en-US
howeve	otherwise*	en-US
however	in contract*	en-US
adm	like*	en-US
admi	adore*	en-US
smal	tiny*	en-US
small	mini*	en-US
delici	appetizing*	en-US
delicio	flavourful*	en-US
deliciou	fuscious*	en-US
excel	amazing*	en-US
excell	wonderful*	en-US
excelle	pleasant*	en-US
excellen	marvelous*	en-US
excellent	stupendous*	en-US
amazi	fantastic*	en-US
amazin	splendid*	en-US
amazing	ferrific*	en-US
fanta	fantastic*	en-US
fantas	astounding*	en-US
fantast	Awesome*	en-US
fantasti	fabulous*	en-US
fantastic	astonishing*	en-US
incre	incredible*	en-US
incred	tremendous*	en-US
incredi	unexpected*	en-US
incredib	phenomenal*	en-US
incredibl	spectacular*	en-US
hila	funny*	en-US
hilar	amusing*	en-US
hilari	entertaining*	en-US
hilario	hilarious*	en-US
hilariou	humorous*	en-US
acu	really*	en-US
acut	absolutely*	en-US
acutl	acutlly*	en-US
acutll	certaintly*	en-US
acutlly	genuinely*	en-US
real	honestly*	en-US
reall	surely*	en-US
really	truly*	en-US
extr	absolutely*	en-US
extre	exceedingly*	en-US
extrem	particulary*	en-US
extreme	tremendously*	en-US
irri	angry*	en-US
irrit	few up*	en-US
irrita	disgusted*	en-US
irritat	outraged*	en-US
irritati	furious*	en-US
irritatin	livid*	en-US
huge	massive*	en-US
hurt	depressed*	en-US
welc	you're welcome.*	en-US
welco	glad to help.*	en-US
welcom	never mention.*	en-US
welcome	I'm happy to help you.*	en-US
sorry	pardom me.*	en-US
wp	what's up?*	en-US
hru	how are you?*	en-US
wtdng	wt r u been up to?*	en-US
k	okay*	en-US
ok	alright*	en-US
oke	sure*	en-US
imb	I'm busy*	en-US
busy	I've lots to do.*	en-US
cul	catch you later.*	en-US
asap	as soon as possible*	en-US
than	thank you!*	en-US
ttyl	talk to you later*	en-US
lmk	let me know*	en-US
ruok	are you okay?*	en-US
wru	where are you?*	en-US
lunch	Have you had lunch?*	en-US
imfine	I am fine, tq. Wt abt you?*	en-US
ask	inquire*	en-US